1111111111111111111111111111111111111
1000000001100010000000000000001111001
1000000000000001000000000000000101111
100000111111000000C000000011111111111
10P000000011000100000000000E000011111
1111111111111111111111111111111111111