1111111111111
100CPC000E111
11111111C1011
1111111111111